




    NO             ./path1  

     SO             ./path2   
   WE             ./path3
      EA             ./path4


     F    1,    1,     1.

   C    1,     1,    1

 1
101111   1
 1000111W
11W010001
 1111111