




           NO             ./path1  

     SO             ./path2   
   WE             ./path3
      EA             ./path4


     F    1,    1,     1.

   C    1,     1,    1



                   1
        1S1
       11111111111111111111111101111111111
       1
       1111111
        1
        1
        1
        1
        1
        1
        1
        1
        1
        1
        1
        1
        1
        1
        1
        1
        1
        1
        1
        1111