   NO             ./path_to_the_north_texture
     SO             ./path_to_the_south_texture
   WE             ./path_to_the_west_texture
      EA             ./path_to_the_east_texture


     F    1,    1,     1
C    1,     1,    1









1111111 111111111
101001 100000001
101001 100000001
111001 100000001
111111 111111111
