




   C    ,  22 ,33




        NO             textures/i1.xpm




     SO                      textures/i2.xpm   



                EA             textures/i3.xpm 

   WE             textures/i4.xpm

     F 10,20        ,30


1111111111111111111111111111111
1111111111111111111111111111111
1000000000000000000000000000011  111111111111111
1000001111110000000000000000011 111111111111111
1000001    1000000000000000011 111111111111111
100000111111000000000000000011 1111111N000000011
1000000000000000000000000000011 111111111111111
1111111111111111111111111111111  111111111111111                              
1111111111111111111111111111111 111111111111 11
1111111111111111111111111111111
1000000000000000000000000000011
1000000000000000000000000000011
1111111111111111111111111111111
1111111111111111111111111111111
1111111111111111111111111111111
