




           NO             ./path1  

     SO             ./path2   
   WE             ./path3
      EA             ./path4


     F    1,    1,     1.
     
   C    1,     1,    1



        111111111111111111111111
        1111111111111111111100000001
        1111111111111111111100  1000001
        1111111111111111111100000001
        1111111111111111111100000001