




   C    66,  22 ,33




        NO             textures/i1.xpm




     SO                      textures/i2.xpm   



                EA             textures/i3.xpm 

   WE             textures/i4.xpm

     F 45,0       ,0


1111111111111111111111111111111
1111111111111111111111111111111
1000000000000000000000000000011  111111111111111
10000011111100000000000000000111111111111111111
1000001    10000000000000000000000001111111111
100000111111000000N000000000011 1111111000000011
1000000000000000000000000000011 111111111111111
1111111111111111111111111111111  111111111111111                              
1111111111111111111111111111111 111111111111 11
1111111111111111111111111111111
1000000000000000000000000000011
1000000000000000000000000000011
1111111111111111111111111111111
1111111111111111111111111111111
1111111111111111111111111111111
